[
    {
        "id":  "2024-03"
    },
    {
        "id":  "2024-04"
    },
    {
        "id":  "2024-05"
    },
    {
        "id":  "2024-06"
    },
    {
        "id":  "2024-07"
    },
    {
        "id":  "2024-08"
    },
    {
        "id":  "2024-09"
    },
    {
        "id":  "2024-10"
    },
    {
        "id":  "2024-11"
    },
    {
        "id":  "2024-12"
    },
    {
        "id":  "2025-01"
    },
    {
        "id":  "2025-02"
    },
    {
        "id":  "2025-03"
    },
    {
        "id":  "2025-04"
    },
    {
        "id":  "2025-05"
    },
    {
        "id":  "2025-06"
    },
    {
        "id":  "2025-07"
    },
    {
        "id":  "2025-08"
    },
    {
        "id":  "2025-09"
    },
    {
        "id":  "2025-10"
    },
    {
        "id":  "2025-11"
    },
    {
        "id":  "2025-12"
    },
    {
        "id":  "2026-01"
    },
    {
        "id":  "2026-02"
    },
    {
        "id":  "2026-03"
    },
    {
        "id":  "2026-04"
    },
    {
        "id":  "2026-05"
    },
    {
        "id":  "2026-06"
    },
    {
        "id":  "2026-07"
    },
    {
        "id":  "2026-08"
    },
    {
        "id":  "2026-09"
    },
    {
        "id":  "2026-10"
    },
    {
        "id":  "2026-11"
    },
    {
        "id":  "2026-12"
    },
    {
        "id":  "2027-01"
    },
    {
        "id":  "2027-02"
    },
    {
        "id":  "2027-03"
    },
    {
        "id":  "2027-04"
    },
    {
        "id":  "2027-05"
    },
    {
        "id":  "2027-06"
    },
    {
        "id":  "2027-07"
    },
    {
        "id":  "2027-08"
    },
    {
        "id":  "2027-09"
    },
    {
        "id":  "2027-10"
    },
    {
        "id":  "2027-11"
    },
    {
        "id":  "2027-12"
    },
    {
        "id":  "2028-01"
    },
    {
        "id":  "2028-02"
    },
    {
        "id":  "2028-03"
    },
    {
        "id":  "2028-04"
    },
    {
        "id":  "2028-05"
    },
    {
        "id":  "2028-06"
    },
    {
        "id":  "2028-07"
    },
    {
        "id":  "2028-08"
    },
    {
        "id":  "2028-09"
    },
    {
        "id":  "2028-10"
    },
    {
        "id":  "2028-11"
    },
    {
        "id":  "2028-12"
    }
]
